111111111111111111111111111111111111111111111111111111111111111111111111111111111111111111111111111111111111111111111111111111111111111111111111111111
100000000000000000000000000000000000000000000000000000000000000000000000000000000000000000000000000000000000000000000000000000000000000000000000000001
100000000000000000000000000000000000000000000000000000000000000000000000000000000000000000000000000000000000000000000000000000000000000000000000000001
100000000000000000000000000000000000000000000000000000000000000000000000000000000000000000000000000000000000000000000000000000000000000000000000000001
100000000000000000000000000000000000000000000000000000000000000000000000000000000000000000000000000000000000000000000000000000000000000000000000000001
100000000000000000000000000000000000000000000000000000000000000000000000000000000000000000000000000000000000000000000000000000000000000000000000000001
100000000000000000000000000000000000000000000000000000000000000000000000000000000000000000000000000000000000000000000000000000000000000000000000000001
100000000000000000000000000000000000000000000000000000000000000000000000000000000000000000000000000000000000000000000000000000000000000000000000000001
100000000000000000000000000000000000000000000000000000000000000000000000000000000000000000000000000000000000000000000000000000000000000000000000000001
100000000000000000000000000000000000000000000000000000000000000000000000000000000000000000000000000000000000000000000000000000000000000000000000000001
100000000000000000000000000000000000000000000000000000000000000000000000000000000000000000000000000000000000000000000000000000000000000000000000000001
100000000000000000000000000000000000000000000000000000000000000000000000000000000000000000000000000000000000000000000000000000000000000000000000000001
100000000000000000000000000000000000000000000000000000000000000000000000000000000000000000000000000000000000000000000000000000000000000000000000000001
100000000000000000000000000000000000000000000000000000000000000000000000000000000000000000000000000000000000000000000000000000000000000000000000000001
100000000000000000000000000000000000000000000000000000000000000000000000000000000000000000000000000000000000000000000000000000000000000000000000000001
100000000000000000000000000000000000000000000000000000000000000000000000000000000000000000000000000000000000000000000000000000000000000000000000000001
100000000000000000000000000000000000000000000000000000000000000000000000000000000000000000000000000000000000000000000000000000000000000000000000000001
100000000000000000000000000000000000000000000000000000000000000000000000000000000000000000000000000000000000000000000000000000000000000000000000000001
100000000000000000000000000000000000000000000000000000000000000000000000000000000000000000000000000000000000000000000000000000000000000000000000000001
100000000000000000000000000000000000000000000000000000000000000000000000000000000000000000000000000000000000000000000000000000000000000000000000000001
100000000000000000000000000000000000000000000000000000000000000000000000000000000000000000000000000000000000000000000000000000000000000000000000000001
100000000000000000000000000000000000000000000000000000000000000000000000000000000000000000000000000000000000000000000000000000000000000000000000000001
100000000000000000000000000000000000000000000000000000000000000000000000000000000000000000000000000000000000000000000000000000000000000000000000000001
100000000000000000000000000000000000000000000000000000000000000000000000000000000000000000000000000000000000000000000000000000000000000000000000000001
100000000000000000000000000000000011111111111111110000011111111111100111111111100000000000000000000001111111111111111100000000000000000000000000000001
100000000000000000000000000000000112222222222222210000012222222222100122222222100000000000000000000001222222222222222110000000000000000000000000000001
100000000000000000000000000000001100000000000000000111000000000000000000000000000000000000000000000000000000000000000011000000000000000000000000000001
100000000000000000000000000000011000000000000000000212000000000000000000000000000000000000000000000000000000000000000001100000000000000000000000000001
100000000000000000000000000000012000000000000000000212000000000000000000000000000000111000000111000000000000000000000002100000000000000000000000000001
100000000000000000000000000000012000000000000000000212000000000122222222100122222222101000000101222222222210000000000002100000000000000000000000000001
100000000000000000000000000000012000000000000000000212000000000000000000000000000000111000000111000000000000000000000002100000000000000000000000000001
100000000000000000000000000000012000000000000000000212000000000000000000000000000000020000000000000000110000000000000002100000000000000000000000000001
100000000000000000000000000000012000000000000000000212000000000000000000000000000000020000000000000000210000000000000002100000000000000000000000000001
100000000000000000000000000000012000000000000000000212000000000000000000000000000000020000000000000000210000000000000002100000000000000000000000000001
100000000000000000000000000000012000000000000000000111000000000000000000000000000000020000000000000000210000000000000002100000000000000000000000000001
100000000000000000000000000000012000110000000000000000000000000000000000000000000000020000000000000000210000000000000011100000000000000000000000000001
100000000000000000000000000000012000210000000000000000000000000000000000000000000000020000000000000000210000000000000010000000000000000000000000000001
100000000000000000000000000000011000210000000000000000000000000000000000000000000000010000000000000000210000000000000011100000000000000000000000000001
100000000000000000000000000000000000210000000000000000000000000000000000000000000000000000000000000000110000000000000002100000000000000000000000000001
100000000000000000000000000000011000210000000000000000000000000000000000000000000000001222222222222221110000000000000002100000000000000000000000000001
100000000000000000000000000000012000210000000000000000000000000000000000000000000000001111111111111111100000000000000002100000000000000000000000000001
100000000000000000000000000000012000110000000000000000000000000000000000000000000000000000000000000000000000000000000002100000000000000000000000000001
100000000000000000000000000000012000000000000000000000000000000000000000000000000000000000000000000000000000000000000002100000000000000000000000000001
100000000000000000000000000000012000000000000000000000000000000000000000000000000000000000000000000000000000000000000002100000000000000000000000000001
100000000000000000000000000000012000000000000000000000000000000000000000000000000000000000000000000000000000000000110002100000000000000000000000000001
100000000000000000000000000000012000110000000000000000000000000000000000000000000000000000000000000000000000000000120002100000000000000000000000000001
100000000000000000000000000000012000210000000000000000000000000000000000000000000000000000000000000000000000000000120002100000000000000000000000000001
100000000000000000000000000000011000210000000000000000000000000000000000000000000000000000000000000000000000000000120002100000000000000000000000000001
100000000000000000000000000000000000210000000000000000000000000000000000000000000000000000000000000000000000000000120001100000000000000000000000000001
100000000000000000000000000000011000210000000000000000000000000000000000000000000000000000000000000000000000000000120000000000000000000000000000000001
100000000000000000000000000000012000210000000000000000000000000000000000000000000000000000000000000000000000000000120000000000000000000000000000000001
100000000000000000000000000000012000110000000000000000000000000000000000000000000000000000000000000000000000000000120000000000000000000000000000000001
100000000000000000000000000000012000000000000000000000000000000000000000000000000000000000000000000000000000000000120000000000000000000000000000000001
100000000000000000000000000000012000000000000000000000000000000000000000000000000000000000000000000000000000000000110000000000000000000000000000000001
100000000000000000000000000000012000000000000000000000000000000000000000000000000000000000000000000000000000000000000000000000000000000000000000000001
100000000000000000000000000000012000000000000000000000000000000000000000000000000000000000000000000000000000000000000000000000000000000000000000000001
100000000000000000000000000000012000000000000000000000000000000000000000000000000000000000000000000000000000000000000000000000000000000000000000000001
100000000000000000000000000000012000000000000000000000000000000000000000000000000000000000000000000000000000000000000000000000000000000000000000000001
100000000000000000000000000000012000000000111000000000000000000000000000000000000000000000000000011100000000000001110000000000000000000000000000000001
100000000000000000000000000000012012222222101000000000000000000000000000000000000000000000000000010100000000000002120000000000000000000000000000000001
100000000000000000000000000000012000000000111000000000000000000000122222221000000000000000000000011100000000000002120000000000000000000000000000000001
100000000000000000000000000000012000000000000000000000000000000000111111111000000000000000000000002000000000000002120000000000000000000000000000000001
100000000000000000000000000000012000000000000000000000000000000000000000000000000000000000000000002000000000000002120000000000000000000000000000000001
100000000000000000000000000000012000000000000000000000000000000011000000000110000000000000000000002000000000000002120001100000000000000000000000000001
100000000000000000000000000000012000000000000000000000000000000021000000000120000000000000000110002000000000000002120002100000000000000000000000000001
100000000000000000000000000000012000000000000000000000000000000021000000000120000000000000000120002000000000000002120002100000000000000000000000000001
100000000000000000000000000000012000000000000000000000000000000021000000000120000000000000000120002000000000000002120002100000000000000000000000000001
100000000000000000000000000000012400000000000000000000000000000021000000000120000000000000000120002000000000000002120002100000000000000000000000000001
100000000000000000000000000000012000000000000000000000000000000021000000000120000000000000000120002000000000000001110002100000000000000000000000000001
100000000000000000000000000000011000000000000000000000000000000021000000000120000000000000000110002000000000000000000002100000000000000000000000000001
100000000000000000000000000000000000000000000000000000000000000021000000000120000000000000000000002000000000000000000002100000000000000000000000000001
100000000000000000000000000000000000300000000000000000000000000011000000000110000000000000000000001000000000000000000001100000000000000000000000000001
100000000000000000000000000000000000000000011100000000111000000000000000000000000000001110000000000000000000000000000011000000000000000000000000000001
100000000000000000000000000000000012222222210122222222101222221000000000000000122222221012222222210122222222222222222110000000000000000000000000000001
100000000000000000000000000000000011111111110111111111101111111000000000000000111111111011111111110111111111111111111100000000000000000000000000000001
100000000000000000000000000000000000000000000000000000000000000000000000000000000000000000000000000000000000000000000000000000000000000000000000000001
100000000000000000000000000000000000000000000000000000000000000000000000000000000000000000000000000000000000000000000000000000000000000000000000000001
100000000000000000000000000000000000000000000000000000000000000000000000000000000000000000000000000000000000000000000000000000000000000000000000000001
100000000000000000000000000000000000000000000000000000000000000000000000000000000000000000000000000000000000000000000000000000000000000000000000000001
100000000000000000000000000000000000000000000000000000000000000000000000000000000000000000000000000000000000000000000000000000000000000000000000000001
100000000000000000000000000000000000000000000000000000000000000000000000000000000000000000000000000000000000000000000000000000000000000000000000000001
100000000000000000000000000000000000000000000000000000000000000000000000000000000000000000000000000000000000000000000000000000000000000000000000000001
100000000000000000000000000000000000000000000000000000000000000000000000000000000000000000000000000000000000000000000000000000000000000000000000000001
100000000000000000000000000000000000000000000000000000000000000000000000000000000000000000000000000000000000000000000000000000000000000000000000000001
100000000000000000000000000000000000000000000000000000000000000000000000000000000000000000000000000000000000000000000000000000000000000000000000000001
100000000000000000000000000000000000000000000000000000000000000000000000000000000000000000000000000000000000000000000000000000000000000000000000000001
100000000000000000000000000000000000000000000000000000000000000000000000000000000000000000000000000000000000000000000000000000000000000000000000000001
100000000000000000000000000000000000000000000000000000000000000000000000000000000000000000000000000000000000000000000000000000000000000000000000000001
100000000000000000000000000000000000000000000000000000000000000000000000000000000000000000000000000000000000000000000000000000000000000000000000000001
100000000000000000000000000000000000000000000000000000000000000000000000000000000000000000000000000000000000000000000000000000000000000000000000000001
100000000000000000000000000000000000000000000000000000000000000000000000000000000000000000000000000000000000000000000000000000000000000000000000000001
100000000000000000000000000000000000000000000000000000000000000000000000000000000000000000000000000000000000000000000000000000000000000000000000000001
100000000000000000000000000000000000000000000000000000000000000000000000000000000000000000000000000000000000000000000000000000000000000000000000000001
100000000000000000000000000000000000000000000000000000000000000000000000000000000000000000000000000000000000000000000000000000000000000000000000000001
100000000000000000000000000000000000000000000000000000000000000000000000000000000000000000000000000000000000000000000000000000000000000000000000000001
100000000000000000000000000000000000000000000000000000000000000000000000000000000000000000000000000000000000000000000000000000000000000000000000000001
100000000000000000000000000000000000000000000000000000000000000000000000000000000000000000000000000000000000000000000000000000000000000000000000000001
100000000000000000000000000000000000000000000000000000000000000000000000000000000000000000000000000000000000000000000000000000000000000000000000000001
100000000000000000000000000000000000000000000000000000000000000000000000000000000000000000000000000000000000000000000000000000000000000000000000000001
111111111111111111111111111111111111111111111111111111111111111111111111111111111111111111111111111111111111111111111111111111111111111111111111111111