1111111111111111111111111111111111111111111111111111111111111111111111111111111111111111111111111111
1000000000000000000000000000000000000000000000000000000000000000000000000000000000000000000000000001
1000000000000000000000000000000000000000000000000000000000000000000000000000000000000000000000000001
1000000000000000000000000000000000000000000000000000000000000000000000000000000000000000000000000001
1000000000000000000000000000000000000000000000000000000000000000000000000000000000000000000000000001
1000000000000000000000000000000000000000000000000000000000000000000000000000000000000000000000000001
1000000000000000000000000000000000000000000000000000000000000000000000000000000000000000000000000001
1000000000000000000000000000000000000000000000000000000000000000000000000000000000000000000000000001
1000000000000000000000000000000000000000000000000000000000000000000000000000000000000000000000000001
1000000000000000000000000000000000000000000000000000000000000000000000000000000000000000000000000001
1000000000000000000000000000000000000000000000000000000000000000000000000000000000000000000000000001
1000000000000000000000000000000000000000000000000000000000000000000000000000000000000000000000000001
1000000000000000000000000000000000000000000000000000000000000000000000000000000000000000000000000001
1000000000000000000000000000000000000000000000000000000000000000000000000000000000000000000000000001
1000000000000000000000000000000000000000000000000000000000000000000000000000000000000000000000000001
1000000000000000000000000000000000000000000000000000000000000000000000000000000000000000000000000001
1000000000000000000000000000000000000000000000000000000000000000000000000000000000000000000000000001
1100000000000000000000000000000000000000000000000000000000000000000000000000000000000000000000000001
1100000000000000000000000000000000000000000000000000000000000000000000000000000000000000000000000001
1100000000000000000000000000000000000000000000000000000000000000000000000000000000000000000000000001
1100000000000000000000000000000000000000000000000000000000000000000000000000000000000000000000000001
1000000000000000000000000000000000000000000000000000000000000000000000000000000000000000000000000001
1000000000000000000000000000000000000000000000000000000000000000000000000000000000000000000000000001
1000000000000000000000000000000000000000000000000000000000000000000000000000000000000000000000000001
1000000000000000000000000000000000000000000000000000000000000000000000000000000000000000000000000001
1000000000000000000000000000000000000000000000000000000000000000000000000000000000000000000000000001
1000000000000000000000000000000000000000000000000000000000000000000000000000000000000000000000000001
1000000000000000000000000000000000000000000000000000000000000000000000000000000000000000000000000001
1000000000000000000000000000000000000000000000000000000000000000000000000000000000000000000000000001
1000000000000000000000000000000000000000000000000000000000000000000000000000000000000000000000000001
1000000000000000000000000000000000000000000000000000000000000000000000000000000000000000000000000001
1000000000000000000000000000000000000000000000000000000000000000000000000000000000000000000000000001
1000000000000000000000000000002220000000000000000000000000000000000000000000000000000000000000000001
1000000000000000000000000000022100000000000000000000000000000000000000000000000000000000000000000001
1000000000000000000000000000021100000000000000000000000000000000000000000000000000000000000000000001
1000000000000000000000000000021200000000000000000000000000000000000000000000000000000000000000000001
1000000000000000000000000000021200000000000000000000000000000000000000000000000000000000000000000001
1000000000000000000000000000021200000000000000000000000000000000000000000000000000000000000000000001
1000000000000000000000000000021200000000000000000000000000000000000000000000000000000000000000000001
1000000000000000000000000000021200000000000000000000000000000000000000000000000000000000000000000001
1100000000000000000000000000021200000000000000000000000000000000000000000000000000000000000000000001
1100000000000000000000000000021200000000000000000000000000000000000000000000000000000000000000000001
1100300000000000000000000000021200000000000000000000000000000000000000000000000000000000000000000001
1000000000000000000000000000021200000000000000000000000000000000000000000000000000000000000000000001
1222222222222222000000000000221222200000000000000000000000000000000000000000000000000000000000000001
1111111111111122222222222222221220222222222200000000000000000000000000000000000000000000000000000001
1000000000000011111111111111111111111111111200000000000000000000000000000000000000000000000000000001
1000000000000000000000000000000000000000001200000000000000000000000000000000000000000000000000000001
1000000000000000000000000000000000000000001200000000000000000000000000000000000000000000000000000001
1000000000000000000000000000000000000000001200000000000000000000000000000000000000000000000000000001
1000000000000000000000000000000000000000001200000000000000000000000000000000000000000000000000000001
1000000000000000000000000000000000000000001200000000000000000000000000000000000000000000000000000001
1000000000000000000000000000000000000000001200000000000000000000000000000000000000000000000000000001
1000000000000000000000000000000000000000001200000000000000000000000000000000000000000000000000000001
1000000000000000000000000000000000000000001220000000000000000000000000000000000000000000000000000001
1000000000000000000000000000000000000000001020000000000000000000000000000000000000000000000000000001
1000000000000000000000000000000000000000001020000000000000000000000000000000000000000000000000000001
1000000000000000000000000000000000000000001220000000000000000000000000000000000000000000000000000001
1000000000000000000000000000000000000000001200000000000000000000000000000000000000000000000000000001
1000000000000000000000000000000000000000001200000000000000000000000000000000000000000000000000000001
1000000000000000000000000000000000000000001200000000000000000000000000000000000000000000000000000001
1000000000000000000000000000000000000000001200000000000000000000000000000000000000000000000000000001
1000000000000000000000000000000000000000001200000000000000000000000000000000000000000000000000000001
1000000000000000000000000011111111111111111200000000000000000000000000000000000000000000000000000001
1000000000000000000000000012222222222222222200000000000000000000000000000000000000000000000000000001
1000000000000000000000000012000000000000000000000000000000000000000000000000000000000000000000000001
1000000000000000000000000012000000000000000000000000000000000000000000000000000000000000000000000001
1000000000000000000000000012000000000000000000000000000000000000000000000000000000000000000000000001
1000000000000000000000000012000000000000000000000000000000000000000000000000000000000000000000000001
1000000000000000000000000012000000000000000000000000000000000000000000000000000000000000000000000001
1000000000000000000000000012000000000000000000000000000000000000000000000000000000000000000000000001
1000000000000000000000000012000000000000000000000000000000000000000000000000000000000000000000000001
1000000000000000000000000012000000000000000000000000000000000000000000000000000000000000000000000001
1000000000000000000000000012000000000000000000000000000000000000000000000000000000000000000000000001
1000000000000000000000000012000000000000000000000000000000000000000000000000000000000000000000000001
1000000000000000000000000012000000000000000000000000000000000000000000000000000000000000000000000001
1000000000000000000000000012000000000000000000000000000000000000000000000000000000000000000000000001
1000000000000000000000000012000000000000000000000000000000000000000000000000000000000000000000000001
1000000000000000000000000102000000000000000000000000000000000000000000000000000000000000000000000001
1000000000000000000000000102222222222222222222222222222222222222220000000000000000000000000000000001
1000000000000000000000000111111110000111111111111111111111111111110000000000000000000000000000000001
1000000000000000000000000000000011111100000000000000000000000000000000000000000000000000000000000001
1000000000000000000000000000000000000000000000000000000000000000000000000000000000000000000000000001
1000000000000000000000000000000000000000000000000000000000000000000000000000000000000000000000000001
1000000000000000000000000000000000000000000000000000000000000000000000000000000000000000000000000001
1000000000000000000000000000000000000000000000000000000000000000000000000000000000000000000000000001
1000000000000000000000000000000000000000000000000000000000000000000000000000000000000000000000000001
1000000000000000000000000000000000000000000000000000000000000000000000000000000000000000000000000001
1000000000000000000000000000000000000000000000000000000000000000000000000000000000000000000000000001
1100000000000000000000000000000000000000000000000000000000000000000000000000000000000000000000000001
1100000000000000000000000000000000000000000000000000000000000000000000000000000000000000000000000001
1100000000000000000000000000000000000000000000000000000000000000000000000000000000000000000000000001
1000000000000000000000000000000000000000000000000000000000000000000000000000000000000000000000000001
1000000000000000000000000000000000000000000000000000000000000000000000000000000000000000000000000001
1000000000000000000000000000000000000000000000000000000000000000000000000000000000000000000000000001
1000000000000000000000000000000000000000000000000000000000000000000000000000000000000000000000000001
1000000000000000000000000000000000000000000000000000000000000000000000000000000000000000000000000001
1000000000000000000000000000000000000000000000000000000000000000000000000000000000000000000000000001
1000000000000000000000000000000000000000000000000000000000000000000000000000000000000000000000000001
1111111111111111111111111111111111111111111111111111111111111111111111111111111111111111111111111111
