11111111111111111111111111111111111111111111111111
10000000000000000000000000000000000000000000000001
10000000000000000000000000000000000000000000000001
10000000000000000000000000000000000000000000000001
10000000000000000000000000000000000000000000000001
10000000000000000000000000000000000000000000000001
10000000000000000000000000000000000000000000000001
10000000000000000000000000000000000000000000000001
10000000000000000000000000000000000000000000000001
10000000000000000000000000000000000000000000000001
10000000000000000000000000000000000000000000000001
10000000000000000000000000000000001111111111111001
10000000000000000000000000000000001222222222221001
10000000000000000000000000000000000000000000001111
10000000000000000000000000000000000000000000000211
10000000000000000000000000000000000000000000000211
10000000000000000000000000122222222210000000000211
10000000000000000000000000111111111110000000000211
10000000000001222222222222100000000000000000000211
10300000000001111111111111100000000000000000000211
12222222222221000000000000000000000000000000000211
11111111111111000000000000000000000000001100000211
10000000000000000000000000000000000000001200000211
10000000000000000000000000000000000000001200000211
10000000000000000000000000000000000000001200000111
10000000000000000000000000000000000000001200000001
10000000000000000000000000000000000000001200000001
10000000000000000000000000000000000000001200000001
10000000000000000000000000000000000000001200000001
10000000000000000000000001110000000000001200000001
10000000000000000000000001010000000000001200000001
10000000000000000000000001110000000000111100000001
10000000000000000000000000200000000000120000000001
10000000000000000000000000200000000000120000000001
10000000000000000000000000200000000000120000000001
10000000000000000000000000200000000000120000000001
10000000000000000000000000200000000000120000000001
10000000000000000000000000200000000000120000110001
10000000000000000000000000200000000000120000210001
10000000000000000000000000200000000000120000210001
10000000000000000000000000200000000000110000210001
10000000000000000000000000200000000000000000210001
10000000000000000000000000200000000000000000210001
10000000000000000000000000200000000000000000210001
10000000000000000000000000200000000000000000210001
10000000004000000000000001110000000000000001110001
10000000122222222222222221012222222222222221000001
10000000111111111111111111011111111111111111000001
10000000000000000000000000000000000000000000000001
11111111111111111111111111111111111111111111111111
