111111111111111111111111111111111111111111111111111111111111111111111111111111111111111111111111111111111111111111111111
100000000000000000000000000000000000000000000000000000000000000000000000000000000000000000000000000000000000000000000001
100000000000000000000000000000000000000000000000000000000000000000000000000000000000000000000000000000000000000000000001
100000000000000000000000000000000000000000000000000000000000000000000000000000000000000000000000000000000000000000000001
100000000000000000000000000000000000000000000000000000000000000000000000000000000000000000000000000000000000000000000001
100000000000000000000000000000000000000000000000000000000000000000000000000000000000000000000000000000000000000000000001
100000000000000000000000000000000000000000000000000000000000000000000000000000000000000000000000000000000000000000000001
100000000000000000000000000000000000000000000000000000000000000000000000000000000000000000000000000000000000000000000001
100000000000000000000000000000000000000000000000000000000000000000000000000000000000000000000000000000000000000000000001
100000000000000000000000000000000000000000000000000000000000000000000000000000000000000000000000000000000000000000000001
100000000000000000000000000000000000000000000000000000000000000000000000000000000000000000000000000000000000000000000001
100000000000000000000000000000000000000000000000000000000000000000000000000000000000000000000000000000000000000000000001
100000000000000000000000000000000000000000000000000000000000000000000000000000000000000000000000000000000000000000000001
100000000000000000000000000000000000000000000000000000000000000000000000000000000000000000000000000000000000000000000001
100000000000000000000000000000000000000000000000000000000000000000000000000000000000000000000000000000000000000000000001
100000000000000000000000000000000000000000000000000000000000000000000000000000000000000000000000000000000000000000000001
100000000000000000000000000000000000000000000000000000000000000000000000000000000000000000000000000000000000000000000001
100000000000000000000000000000000000000000000000000000000000000000000000000000000000000000000000000000000000000000000001
100000000000000000000000000000000000000000000000000000000000000000000000000000000000000000000000000000000000000000000001
100000000000000000000000000000000000000000000000000000000000000000000000000000000000000000000000000000000000000000000001
100000000000000000000000000000000000000000000000000000000000000000000000000000000000000000000000000000000000000000000001
100000000000000000000000000000000000000000000000000000000000000000000000000000000000000000000000000000000000000000000001
100000000000000000000000000000000000000000000000000000000000000000000000000000000000000000000000000000000000000000000001
100000000000000000000000000000000000000000000000000000000000000000000000000000000000000000000000000000000000000000000001
100000000000000000000000000000000000000000000000000000000000000000000000000000000000000000000000000000000000000000000001
100000000000000000000000000000000000000000000000000000000000000000000000000000000000000000000000000000000000000000000001
100000000000000000000000000000000000000000000000000000000000000000000000000000000000000000000000000000000000000000000001
100000000000000000000000000000000000000000000000000000000000000000000000000000000000000000000000000000000000000000000001
100000000000000000000000000000000000000000000000000000000000000000000000000000000000000000000000000000000000000000000001
100000000000000000000000000000000000000000000000000000000000000000000000000000000000000000000000000000000000000000000001
100000000000000000000000000000000000000000000000000000000000000000000000000000000000000000000000000000000000000000000001
100000000000000000000000000000000000000000000000000000000000000000000000000000000000000000000000000000000000000000000001
100000000000000000000000000000000000000000000000000000000000000000000000000000000000000000000000000000000000000000000001
100000000000000000000000000000000000000000000000000000000000000000000000000000000000000000000000000000000000000000000001
100000000000000000000000000000000000000000000000000000000000000000000000000000000000000000000000000000000000000000000001
100000000000000000000000000000000000000000000000000000000000000000000000000000000000000000000000000000000000000000000001
100000000000000000000000000000000000000000000000000000000000000000000000000000000000000000000000000000000000000000000001
100000000000000000000000000000000000000000000000000000000000000000000000000000000000000000000000000000000000000000000001
100000000000000000000000000000000000000000000000000000000000000400000000000000000000000000000000000000000000000000000001
100000000000000000000000000000000000000000000000000000122222222221000000000000000000000000000000000000000000000000000001
100000000000000000000000000000000000000000000000000000111111111111000000000000000000000000000000000000000000000000000001
100000000000000000000000000000000000000000000000000000122222222221000000000000000000000000000000000000000000000000000001
100000000000000000000000000000000000000000000000000000000000000000000000000000000000000000000000000000000000000000000001
100000000000000000000000000000000000000000000000000000000000000000000000000000000000000000000000000000000000000000000001
100000000000000000000000000000000000000000000000000000000000000000000000000000000000000000000000000000000000000000000001
100000000000000000000000000000000000000000000000000000000000122222222221110000000000000000000000000000000000000000000001
100000000000000000000000000000000000000000000000000000000000111111111111010000000000000000000000000000000000000000000001
100000000000000000000000000000000000000000000000000000000000000000000001110000000000000000000000000000000000000000000001
100000000000000000000000000000000000000000000000000000000000000000000000120000000000000000000000000000000000000000000001
100000000000000000000000000000000000000000000000011100000000000000000000120000000000000000000000000000000000000000000001
100000000000000000000000000000000000000000000000010100000000000000000000120000000000000000000000000000000000000000000001
100000000000000000000000000000000000000000000000011100000000000000000000120000000000000000000000000000000000000000000001
100000000000000000000000000000000000000000000000002000000000000000000000120001100000000000000000000000000000000000000001
100000000000000000000000000000000000000000000000002000000000000000000000120002100000000000000000000000000000000000000001
100000000000000000000000000000000000000000000000002000000000000000000000120002100000000000000000000000000000000000000001
100000000000000000000000000000000000000000000000002000000000000000000000120002100000000000000000000000000000000000000001
100000000000000000000000000000000000000000000000002000000000000000000000120002100000000000000000000000000000000000000001
100000000000000000000000000000000000000000000000002000000000000000000000110002100000000000000000000000000000000000000001
100000000000000000000000000000000000000000000000002000000000000000000000000002100000000000000000000000000000000000000001
100000000000000000000000000000000000000000000000002000000000000000000000000002100000000000000000000000000000000000000001
100000000000000000000000000000000000000000000000002000000000000000000000000002100000000000000000000000000000000000000001
100000000000000000000000000000000000030000000000002000000000000000000000000002100000000000000000000000000000000000000001
100000000000000000000000000000000111000000000000011100000000001110000000000002100000000000000000000000000000000000000001
100000000000000000000000000000000101222222222222210122222222221010000000000011100000000000000000000000000000000000000001
100000000000000000000000000000000111000000000000011100000000001110000000000010000000000000000000000000000000000000000001
100000000000000000000000000000000000000000000000002000000000000000000000000011100000000000000000000000000000000000000001
100000000000000000000000000000000000000000000000002000000000000000000000000002100000000000000000000000000000000000000001
100000000000000000000000000000000000000000000000002000000000000000000000000002100000000000000000000000000000000000000001
100000000000000000000000000000000000000000000000002000000000000000000000000002100000000000000000000000000000000000000001
100000000000000000000000000000000000000000000000002000000000000000000000000002100000000000000000000000000000000000000001
100000000000000000000000000000000000000000000000002000000000000000000000000002100000000000000000000000000000000000000001
100000000000000000000000000000000000000000000000002000000000000000000000000002100000000000000000000000000000000000000001
100000000000000000000000000000000000000000000000002000000000000000000000000002100000000000000000000000000000000000000001
100000000000000000000000000000000000000000000000002000000000000000000000000002100000000000000000000000000000000000000001
100000000000000000000000000000000000000000000000002000000000000000000000000002100000000000000000000000000000000000000001
100000000000000000000000000000000000000000000000001000000000000000000000000002100000000000000000000000000000000000000001
100000000000000000000000000000000000000000000000000000000000000111000000000001100000000000000000000000000000000000000001
100000000000000000000000000000000000000000000000000012222222222101222222222211000000000000000000000000000000000000000001
100000000000000000000000000000000000000000000000000011111111111101111111111110000000000000000000000000000000000000000001
100000000000000000000000000000000000000000000000000000000000000000000000000000000000000000000000000000000000000000000001
100000000000000000000000000000000000000000000000000000000000000000000000000000000000000000000000000000000000000000000001
100000000000000000000000000000000000000000000000000000000000000000000000000000000000000000000000000000000000000000000001
100000000000000000000000000000000000000000000000000000000000000000000000000000000000000000000000000000000000000000000001
100000000000000000000000000000000000000000000000000000000000000000000000000000000000000000000000000000000000000000000001
100000000000000000000000000000000000000000000000000000000000000000000000000000000000000000000000000000000000000000000001
100000000000000000000000000000000000000000000000000000000000000000000000000000000000000000000000000000000000000000000001
100000000000000000000000000000000000000000000000000000000000000000000000000000000000000000000000000000000000000000000001
100000000000000000000000000000000000000000000000000000000000000000000000000000000000000000000000000000000000000000000001
100000000000000000000000000000000000000000000000000000000000000000000000000000000000000000000000000000000000000000000001
100000000000000000000000000000000000000000000000000000000000000000000000000000000000000000000000000000000000000000000001
100000000000000000000000000000000000000000000000000000000000000000000000000000000000000000000000000000000000000000000001
100000000000000000000000000000000000000000000000000000000000000000000000000000000000000000000000000000000000000000000001
100000000000000000000000000000000000000000000000000000000000000000000000000000000000000000000000000000000000000000000001
100000000000000000000000000000000000000000000000000000000000000000000000000000000000000000000000000000000000000000000001
100000000000000000000000000000000000000000000000000000000000000000000000000000000000000000000000000000000000000000000001
100000000000000000000000000000000000000000000000000000000000000000000000000000000000000000000000000000000000000000000001
100000000000000000000000000000000000000000000000000000000000000000000000000000000000000000000000000000000000000000000001
100000000000000000000000000000000000000000000000000000000000000000000000000000000000000000000000000000000000000000000001
100000000000000000000000000000000000000000000000000000000000000000000000000000000000000000000000000000000000000000000001
100000000000000000000000000000000000000000000000000000000000000000000000000000000000000000000000000000000000000000000001
100000000000000000000000000000000000000000000000000000000000000000000000000000000000000000000000000000000000000000000001
100000000000000000000000000000000000000000000000000000000000000000000000000000000000000000000000000000000000000000000001
100000000000000000000000000000000000000000000000000000000000000000000000000000000000000000000000000000000000000000000001
100000000000000000000000000000000000000000000000000000000000000000000000000000000000000000000000000000000000000000000001
100000000000000000000000000000000000000000000000000000000000000000000000000000000000000000000000000000000000000000000001
100000000000000000000000000000000000000000000000000000000000000000000000000000000000000000000000000000000000000000000001
100000000000000000000000000000000000000000000000000000000000000000000000000000000000000000000000000000000000000000000001
100000000000000000000000000000000000000000000000000000000000000000000000000000000000000000000000000000000000000000000001
100000000000000000000000000000000000000000000000000000000000000000000000000000000000000000000000000000000000000000000001
100000000000000000000000000000000000000000000000000000000000000000000000000000000000000000000000000000000000000000000001
100000000000000000000000000000000000000000000000000000000000000000000000000000000000000000000000000000000000000000000001
100000000000000000000000000000000000000000000000000000000000000000000000000000000000000000000000000000000000000000000001
100000000000000000000000000000000000000000000000000000000000000000000000000000000000000000000000000000000000000000000001
100000000000000000000000000000000000000000000000000000000000000000000000000000000000000000000000000000000000000000000001
100000000000000000000000000000000000000000000000000000000000000000000000000000000000000000000000000000000000000000000001
100000000000000000000000000000000000000000000000000000000000000000000000000000000000000000000000000000000000000000000001
100000000000000000000000000000000000000000000000000000000000000000000000000000000000000000000000000000000000000000000001
100000000000000000000000000000000000000000000000000000000000000000000000000000000000000000000000000000000000000000000001
100000000000000000000000000000000000000000000000000000000000000000000000000000000000000000000000000000000000000000000001
111111111111111111111111111111111111111111111111111111111111111111111111111111111111111111111111111111111111111111111111
