11111111111111111111111111111111111111111111111111
10000000000000000000000000000000000000000000000001
10000000000000000000000000000000000000000000000001
10000000000000000000000000000000000000000000000001
10000000000000000000000000000000000000000000000001
10000000000000000000000000000001110000000000000001
10000000000000000000000000000001010000000000000001
10000000000000000000000000000001110000000000000001
10000000000000000000000000000000200000000000000001
10000000000000000000000000000000200000000000000001
10000000000000000000000000000000200000000000000001
10000000000000000000000000000000200000000000000001
10000000000000000000000000000000200000000000000001
10000000000000000000000000000000200000000000000001
10000000000000000000000000000000200000000000000001
10000000000000000000000000000000200000000000000001
10000000000000000000000000000000200000000000000001
10000000000000000000000000000000200000000000000001
10000000000000000000000000000000200000000000000001
10000000000000111000000000000001110000000111000001
10000000000000101222222222222221012222222101000001
10000000000000111000000000000001111111111111000001
10000000000000000000000000000000210000000120000001
10000000000000000000000000000000210000000120000001
10000000000000000000000000000000210000000120000001
10000000000000000000000000000000210000000120000001
10000000000000000000000000000000210000000120000001
10000000000000000000000000000000210000000120000001
10000000000000000000000000000000210000000120000001
10000000000000000000000000000000210000000120000001
10000000000000000000000000000000210000000120000001
10000000000000000000000000000001110000000120000011
10000000000000000000000000000001000000000120000021
10000000000000000000000000000001110000000120000021
10000000000000000000000000000000210000000110000021
10000000000000000000000000000000210000000000000021
10000000000000000000000000000000210000000000000021
10000000000000000000000000000000210000000000000021
10000000000000000000000000000000210000000000000021
10000000000000000000000000000000210000001100000021
10000000000000000000000000000000210000001200000021
10000000000000000000000000000000210000001200000011
10000000000000000000000000000000210000001200000001
10000000000000000000000000000000210000001200000001
10000000000000000000000000000000210000001200000001
10003000000000111000000000000001110000001240000001
11122222222222101222222222222221000000001200000001
11111111111111111111111111111111000000001200000001
11111111111111111111111111111111000000001100000001
11111111111111111111111111111111111111111111111111
