11111111111111111111111111111111111111111111111111
10000000000000000000000000000000000000000000000001
10000000000000000000000000000000000000000000000001
10000000000000000000000000000000000000000000000001
10000000000000000000000000000000000000000000000001
10000000000000000000000000000000000000000000000001
10000000000000000000000000000000000000000000000001
10000000000000000000000000000000000000000000000001
10000000111000000000000000000000000000000000000001
10000000101000000000000000000000000000000000000001
10000000111000000000000000000000000000000000000001
10000000020000000000000000000000000000000000000001
10000000020000000000000000000000000000000000000001
10000000020000000000000000000000000000000000000001
10000000020000000000000000000000000000000000000001
10000000020000000000000000000000000000000000000001
10000000020000000000000000000000000000000000000001
10000000020000000000000000000000000000000000000001
10000000020000000000000000000000000000000000000001
10000000020000000000000000000000000000000000000001
10000000020000000000000000000000000000000000000001
10000000020000000000000000000000000000000000000001
10000000020000000000000000000000000000000000000001
10000000020000011111111111111100000000000000000001
10000000020000012222222222222100000000000000000001
10000000020000000000000000000000000000000000000001
10000300020000000000000000000000000000000000000001
10100000010000000000000000000000000000000111000001
12222222211222222222111111122222222222222101000001
11111111111111111111111110000000000000000111000001
10000000000000000000000120000000000000000000000001
10000000000000000000000120000000000000000000000001
10000000000000000000000120000000000000000000000001
10000000000000000000000120000000000000000000000001
10000000000000000000000120000000000000000000000001
10000000000000000000000120000000000000000000000001
10000000000000000000000120000000000000000000000001
10000000000000000000000120000000000000000000000001
10000000000000000000000120000000000000000000000001
10001111111111111111111111000000000000000000000001
10001222222222222222222101000000000000000000000001
10000010000000000000000111000000000000000000000001
10000000000000000000000000000000000000000000000001
10000000000000000000000000000000000000000000000001
10000000000000000000000000000000000000000000000001
10000000000000000000000000000000000000000000000001
10000000000000000000000000000000000000000000000001
10000000000000000000000000000000000000000000000001
10000000000000000000000000000000000000000000000001
11111111111111111111111111111111111111111111111111
