11111111111111111111111111111111111111111111111111
10000000000000000000000000000000000000000000000001
10000000000000000000000000000000000000000000000001
10000000000000000000000000000000000000000000000001
10000000000000000000000000000000000000000000000001
10000000000000000000000000000000000000000000000001
10000000000000000000000000000000000000000000000001
10000000000000000000000000000000000000000000000001
10000000000000000000000000000000000000000000000001
10000000000000000000000000000000000000000000000001
10000000000000000000000000000000000000000000000001
10000000000000000000000000000000001111111111111001
10000000000000000000000000000000001222222222221001
10000000000000000000000000000000000000000000001111
10000000000000000000000000000000000000000000000211
10000000000000000000000000000000000000000000000211
10000000000000000000000000122222222210000000000211
10000000000000000000000000111111111110000000000211
10000000000001222222222222100000000000000000000211
10300000000001111111111111100000000000000000000211
12222222222221000000000000000000000000000000000211
11111111111111000000000000000000000000000011000211
10000000000000000000000000000000000000000012000211
10000000000000000000000000000000000000000012000211
10000000000000000000000000000000000000000012000111
10000000000000000000000000000000000000000012000001
10000000000000000000000000000000000000000012000001
10000000000000000000000000000000000000000012000001
10000000000000000000000000000000000000000012000001
10000000000000000000000001110000000000000012000001
10000000000000000000000001010000000000000012000001
10000000000000000000000001110000000001111101000001
10000000000000000000000000200000000001222211000001
10000000000000000000000000200000000001200000000001
10000000000000000000000000200000000001200000000001
10000000000000000000000000200000000001200000000001
10000000000000000000000000200000000001200000000001
10000000000000000000000000200000000001200000000001
10000000000000000000000000200000000001200011000001
10000000000000000000000000200000000001200021000001
10000000000000000000000000200000000001100021000001
10000000000000000000000000200000000000000021000001
10000000000000000000000000200000000000000021000001
10000000000000000000000000200000000000000021000001
10000000000000000000000000200000000000000021000001
10000000004000000000000001110000000000000111000001
10000000122222222222222221012222222222222100000001
10000000111111111111111111011111111111111100000001
10000000000000000000000000000000000000000000000001
11111111111111111111111111111111111111111111111111
