11111111111111111111111111101111111111111111111111
11112222222222222222222222101222222222222222221111
11100000000000000000000000000000000000000000000111
11000000000000000000000000000000000000000000000011
11000000000000000000000000000000000000000000000011
12000000000000000000000000000000000001110000000021
12000000111000000000012222222221000001010000000021
12000000101000000000011111111111000001110000000021
12000000111000000000000000000000000000000000000021
12000000000000000000000000000000000000000000000021
12000000000000000000000000000000000000000000000021
12000000000000000000000000000000000000000000000111
12000000000000000000000000000000000000000000000101
12000000000000000000000000000000000000000000000111
11100000000000000000000000000000000000000000000021
10100000000000000000000000000000000000000000000021
11100000000000000000000000000000000000000000000021
12000000000000000000000000000000000000000000000021
12000000000000000000000000000000000000000000000021
12000000000000000000000000000000000000000000000021
12000011100000000000000000000000000000000000000021
12000010100000000000000000111000000000000000000011
12000011100000000000000000101222222222222222222211
12000000000000000000000000111000000000000000000011
12000000000000000000000000000000000000000000000021
12000000000000000000000000000000000000000000000021
12000000000000000000000000000000000000000000000021
12000000000000000000000000000000000000000000000021
12000000000000000000000000000000000000000000000021
12000000000000000000000000000000000000000000000021
12000000000000000000000000000000000000000011000021
12000000000000000000000000000000000000000012000021
12000000000000000000000000000000000000000012000021
12000000000000000000000000000000000000000012000021
11100000000000000000000000000000000000000012000021
10100000000000000000000000000000000000000012000011
11100000000000000000000000000000000000000012000001
12000000000000000000000000000000000000000012000001
12000000000000000000000000000000000000000012000001
12000000000000000000000000000000000000000012000011
12000000000000000000000000000000000000000012000021
12000000000000000000000000000000000000000012000021
12000000000000000000000000000000000000000011000021
12000000000011100000000000000000000000000000000021
12400000000010100000000000000000000000000000000021
12000000000011100000000000000000000000000000000021
12000000000000000000000000000000000000000000000021
11000000000000000000000000000000000000000000000011
11100030000000000000011100000000111000000000000111
11112222222222222222212122222222101222222222221111
11111111111111111111111111111111111111111111111111
