11111111111111111111111111111111111111111111111111
10000000000000000000000000000000000000000000000001
10000000000000000000000000000000000000000000000001
10000000000000000000000000000000000000000000000001
10000000000000000000000000000000000000000000000001
10000000000004000000000011100000000000000000000001
10000000000122222222222210122222222222211100000001
10000000000111111111111110111111111111110100000001
10000000000000000000000000000000000000001200000001
10000000000000000000000000000000000000001200001111
10000000000000000000000000000000000000001200002111
10000000000000000000000000000000000000001200002111
10000000000000000000000000000000000000001200002111
10000000000000000000000000000000000000001200002111
10000000000000000000000000000000000000001200002111
10000000000000000000000000000000000000001100002111
10000000000000000000000000000000000000000000002111
10000000000000000000000111000000000000000000001111
10000000000000000000000101000000000000000000000021
10000000000000000000000111000000000000000000000021
10000000000000000000000020000000000000000000000021
10000000000000000000000020000000000000000000000021
10000000000000000000000020000000000000000000000021
10000000000000000000000020000000000000000000000021
10000000000000000000000020000000000000000000000021
10000000000000000000000020000000000000000000000021
10000000000000000000000020000000000000000000000111
10000000000000000000000020000000000000000000000101
10000000000000000000000020000000000000000000000111
10000000000000000000000020000000000000000000000021
10000000000000000000000020000000000000000000000021
10000000000000000000000020000000000000000000000021
10000000000000000000000020000000000000000000000021
10000000000000000000000010000000000000000000000021
10000030000000000000000111000000000011100000000021
10001222222222222222221101122222222210100000000021
10001111111111111111111111000000000011100000000021
10000000000000000000000110000000000000000000000021
10000000000000000000000120000000000000000000000021
10000000000000000000000120000000000000000000000021
10000000000000000000000120000000000000000000000021
10000000000000000000000120000000000000000000000021
10000000000000000000000120000000000000000000000021
10000000000000000000000120000000000000000000000021
10000000000000000000000120000000000000000000000021
10000000000000000000000120000000000000000000000021
10000000000000000000000120000000000000000000000011
10000000000000000000000111000000000000000000000111
10000000000000000000000001222222222222111222221110
11111111111111111111111111111111111111101111111110