111111111111111111111111111111111111111111111111111111111111111111111111111111111111111111111111111111111111111111111111111111111111111111111111111111
100000000000000000000000000000000000000000000000000000000000000000000000000000000000000000000000000000000000000000000000000000000000000000000000000001
100000000000000000000000000000000000000000000000000000000000000000000000000000000000000000000000000000000000000000000000000000000000000000000000000001
100000000000000000000000000000000000000000000000000000000000000000000000000000000000000000000000000000000000000000000000000000000000000000000000000001
100000000000000000000000000000000000000000000000000000000000000000000000000000000000000000000000000000000000000000000000000000000000000000000000000001
100000000000000000000000000000000000000000000000000000000000000000000000000000000000000000000000000000000000000000000000000000000000000000000000000001
100000000000000000000000000000000000000000000000000000000000000000000000000000000000000000000000000000000000000000000000000000000000000000000000000001
100000000000000000000000000000000000000000000000000000000000000000000000000000000000000000000000000000000000000000000000000000000000000000000000000001
100000000000000000000000000000000000000000000000000000000000000000000000000000000000000000000000000000000000000000000000000000000000000000000000000001
100000000000000000000000000000000000000000000000000000000000000000000000000000000000000000000000000000000000000000000000000000000000000000000000000001
100000000000000000000000000000000000000000000000000000000000000000000000000000000000000000000000000000000000000000000000000000000000000000000000000001
100000000000000000000000000000000000000000000000000000000000000000000000000000000000000000000000000000000000000000000000000000000000000000000000000001
100000000000000000000000000000000000000000000000000000000000000000000000000000000000000000000000000000000000000000000000000000000000000000000000000001
100000000000000000000000000000000000000000000000000000000000000000000000000000000000000000000000000000000000000000000000000000000000000000000000000001
100000000000000000000000000000000000000000000000000000000000000000000000000000000000000000000000000000000000000000000000000000000000000000000000000001
100000000000000000000000000000000000000000000000000000000000000000000000000000000000000000000000000000000000000000000000000000000000000000000000000001
100000000000000000000000000000000000000000000000000000000000000000000000000000000000000000000000000000000000000000000000000000000000000000000000000001
100000000000000000000000000000000000000000000000000000000000000000000000000000000000000000000000000000000000000000000000000000000000000000000000000001
100000000000000000000000000000000000000000000000000000000000000000000000000000000000000000000000000000000000000000000000000000000000000000000000000001
100000000000000000000000000000000000000000000000000000000000000000000000000000000000000000000000000000000000000000000000000000000000000000000000000001
100000000000000000000000000000000000000000000000000000000000000000000000000000000000000000000000000000000000000000000000000000000000000000000000000001
100000000000000000000000000000000000000000000000000000000000000000000000000000000000000000000000000000000000000000000000000000000000000000000000000001
100000000000000000000000000000000000000000000000000000000000000000000000000000000000000000000000000000000000000000000000000000000000000000000000000001
100000000000000000000000000000000000000000000000000000000000000000000000000000000000000000000000000000000000000000000000000000000000000000000000000001
100000000000000000000000000000000000000000000000000000000000000000000000000000000000000000000000000000000000000000000000000000000000000000000000000001
100000000000000000000000000000000000000000000000000000000000000000000000000000000000000000000000000000000000000000000000000000000000000000000000000001
100000000000000000000000000000000000000000000000000000000000000000000000000000000000000000000000000000000000000000000000000000000000000000000000000001
100000000000000000000000000000000000000000000000000000000000000000000000000000000000000000000000000000000000000000000000000000000000000000000000000001
100000000000000000000000000000000000000000000000000000000000000000000000000000000000000000000000000000000000000000000000000000000000000000000000000001
100000000000000000000000000000000000000000000000000000000000000000000000000000000000000000000000000000000000000000000000000000000000000000000000000001
100000000000000000000000000000000000000000000000000000000000000000000000000000000000000000000000000000000000000000000000000000000000000000000000000001
100000000000000000000000000000000000000000000000000000000000000000000000000000000000000000000000000000000000000000000000000000000000000000000000000001
100000000000000000000000000000000000000000000000000000000000000000000000000000000000000000000000000000000000000000000000000000000000000000000000000001
100000000000000000000000000000000000000000000000000000000000000000000000000000000000000000000000000000000000000000000000000000000000000000000000000001
100000000000000000000000000000000000000000000000000000000000000000000000000000000000000000000000000000000000000000000000000000000000000000000000000001
100000000000000000000000000000000000000000000000000000000000000000000000000000000000000000000000000000000000000000000000000000000000000000000000000001
100000000000000000000000000000000000000000000000000000000000000000000000000000000000000000000000000000000000000000000000000000000000000000000000000001
100000000000000000000000000000000000000000000000000000000000000000000000000000000000000000000000000000000000000000000000000000000000000000000000000001
100000000000000000000000000000000000000000000000000000000000000000000000000000000000000000000000000000000000000000000000000000000000000000000000000001
100000000000000000000000000000000000000000000000000000000000000000000000000000000000000000000000000000000000000000000000000000000000000000000000000001
100000000000000000000000000000000000000000000000000000000000000000000000000000000000000000000000000000000000000000000000000000000000000000000000000001
100000000000000000000000000000000000000000000000000000000000000000000000000000000000000000000000000000000000000000000000000000000000000000000000000001
100000000000000000000000000000000000000000000000000000000000000000000000000000000000000000000000000000000000000000000000000000000000000000000000000001
100000000000000000000000000000000000000000000000000000000000000000000000000000000000000000000000000000000000000000000000000000000000000000000000000001
100000000000000000000000000000000000000000000000000000000000000000000000000000000000000000000000000000000000000000000000000000000000000000000000000001
100000000000000000000000000000000000000000000000000000000000000000000000000000000000000000000000000000000000000000000000000000000000000000000000000001
100000000000000000000000000000000000000000000000000000000000000000000000000000000000000000000000000000000000000000000000000000000000000000000000000001
100000000000000000000000000000000000000000000000000000000000000000000000000000000000000000000000000000000000000000000000000000000000000000000000000001
100000000000000000000000000000000000000000000000000000000000000000000000000000000000000000000000000000000000000000000000000000000000000000000000000001
100000000000000000000000000000000000000000000000000000000000000000000000000000000000000000000000000000000000000000000000000000000000000000000000000001
100000000000000000000000000000000000000000000000000000000000000000000000000000000000000000000000000000000000000000000000000000000000000000000000000001
100000000000000000000000000000000000000000000000000000000000000000000000000000000000000000000000000000000000000000000000000000000000000000000000000001
100000000000000000000000000000000000000000000000000000000000000000000000000000000000000000000000000000000000000000000000000000000000000000000000000001
100000000000000000000000000000000000000000000000000000000000000000000000000000000000000000000000000000000000000000000000000000000000000000000000000001
100000000000000000000000000000000000000000000000000000000000000000000000000000000000000000000000000000000000000000000000000000000000000000000000000001
100000000000000000000000000000000000000000000000000000000000000000000000000000000000000000000000000000000000000000000000000000000000000000000000000001
100000000000000000000000000000000000000000000000000000000000000000000000000000000000000000000000000000000000000000000000000000000000000000000000000001
100000000000000000000000000000000000000000000000000000000000000000000000000000000000000000000000000000000000000000000000000000000000000000000000000001
100000000000000000000000000000000000000000000000000000000000000000000000000000000000000000000000000000000000000000000000000000000000000000000000000001
100000000000000000000000000000000000000000000000000000000000000000000000000000000000000000000000000000000000000000000000000000000000000000000000000001
100000000000000000000000000000000000000000000000000000000000000000000000000000000000000000000000000000000000000000000000000000000000000000000000000001
100000000000000000000000000000000000000000000000000000000000000000000000000000000000000000000000000000000000000000000000000000000000000000000000000001
100000000000000000000000000000000000000000000000000000000000000000000000000000000000000000000000000000000000000000000000000000000000000000000000000001
100000000000000000000000000000000000000000000000000000000000000000000000000000000000000000000000000000000000000000000000000000000000000000000000000001
100000000000000000000000000000000000000000000000000000000000000000000000000000000000000000000000000000000000000000000000000000000000000000000000000001
100000000000000000000000000000000000000000000000000000000000000000000000000000000000000000000000000000000000000000000000000000000000000000000000000001
100000000000000000000000000000000000000000000000000000000000000000000000000000000000000000000000000000000000000000000000000000000000000000000000000001
100000000000000000000000000000000000000000000000000000000000000000000000000000000000000000000000000000000000000000000000000000000000000000000000000001
100000000000000000000000000000000000000000000000000000000000000000000000000000000000000000000000000000000000000000000000000000000000000000000000000001
100000000000000000000000000000000111111111111111100000111111111111001111111111000000000000000000000011111111111111111000000000000000000000000000000001
100000000000000000000000000000001122222222222222100000122222222221001222222221000000000000000000000012222222222222221100000000000000000000000000000001
100000000000000000000000000000011000000000000000001110000000000000000000000000000000000000000000000000000000000000000110000000000000000000000000000001
100000000000000000000000000000110000000000000000002120000000000000000000000000000000000000000000000000000000000000000011000000000000000000000000000001
100000000000000000000000000000120000000000000000002120000000000000000000000000000011100000001110000000000000000000000021000000000000000000000000000001
100000000000000000000000000000120000000000000000002120000000012222222221001222222210100000001012222222222100000000000021000000000000000000000000000001
100000000000000000000000000000120000000000000000002120000000000000000000000000000011100000001110000000000000000000000021000000000000000000000000000001
100000000000000000000000000000120000000000000000002120000000000000000000000000000001200000000000000001100000000000000021000000000000000000000000000001
100000000000000000000000000000120000000000000000002120000000000000000000000000000001200000000000000002100000000000000021000000000000000000000000000001
100000000000000000000000000000120000000000000000002120000000000000000000000000000001200000000000000002100000000000000021000000000000000000000000000001
100000000000000000000000000000120000000000000000001110000000000000000000000000000001200000000000000002100000000000000021000000000000000000000000000001
100000000000000000000000000000120001100000000000000000000000000000000000000000000001200000000000000002100000000000000111000000000000000000000000000001
100000000000000000000000000000120002100000000000000000000000000000000000000000000001200000000000000002100000000000000100000000000000000000000000000001
100000000000000000000000000000110002100000000000000000000000000000000000000000000001100000000000000002100000000000000111000000000000000000000000000001
100000000000000000000000000000000002100000000000000000000000000000000000000000000000000000000000000001100000000000000021000000000000000000000000000001
100000000000000000000000000000110002100000000000000000000000000000000000000000000000012222222222222211100000000000000021000000000000000000000000000001
100000000000000000000000000000120002100000000000000000000000000000000000000000000000011111111111111111000000000000000021000000000000000000000000000001
100000000000000000000000000000120001100000000000000000000000000000000000000000000000000000000000000000000000000000000021000000000000000000000000000001
100000000000000000000000000000120000000000000000000000000000000000000000000000000000000000000000000000000000000000000021000000000000000000000000000001
100000000000000000000000000000120000000000000000000000000000000000000000000000000000000000000000000000000000000000000021000000000000000000000000000001
100000000000000000000000000000120000000000000000000000000000000000000000000000000000000000000000000000000000000001100021000000000000000000000000000001
100000000000000000000000000000120001100000000000000000000000000000000000000000000000000000000000000000000000000001200021000000000000000000000000000001
100000000000000000000000000000120002100000000000000000000000000000000000000000000000000000000000000000000000000001200021000000000000000000000000000001
100000000000000000000000000000110002100000000000000000000000000000000000000000000000000000000000000000000000000001200021000000000000000000000000000001
100000000000000000000000000000000002100000000000000000000000000000000000000000000000000000000000000000000000000001200011000000000000000000000000000001
100000000000000000000000000000110002100000000000000000000000000000000000000000000000000000000000000000000000000001200000000000000000000000000000000001
100000000000000000000000000000120002100000000000000000000000000000000000000000000000000000000000000000000000000001200000000000000000000000000000000001
100000000000000000000000000000120001100000000000000000000000000000000000000000000000000000000000000000000000000001200000000000000000000000000000000001
100000000000000000000000000000120000000000000000000000000000000000000000000000000000000000000000000000000000000001200000000000000000000000000000000001
100000000000000000000000000000120000000000000000000000000000000000000000000000000000000000000000000000000000000001100000000000000000000000000000000001
100000000000000000000000000000120000000000000000000000000000000000000000000000000000000000000000000000000000000000000000000000000000000000000000000001
100000000000000000000000000000120000000000000000000000000000000000000000000000000000000000000000000000000000000000000000000000000000000000000000000001
100000000000000000000000000000120000000000000000000000000000000000000000000000000000000000000000000000000000000000000000000000000000000000000000000001
100000000000000000000000000000120000000000000000000000000000000000000000000000000000000000000000000000000000000000000000000000000000000000000000000001
100000000000000000000000000000120000000001110000000000000000000000000000000000000000000000000000111000000000000011100000000000000000000000000000000001
100000000000000000000000000000120122222221010000000000000000000000000000000000000000000000000000101000000000000021200000000000000000000000000000000001
100000000000000000000000000000120000000001110000000000000000000001222222210000000000000000000000111000000000000021200000000000000000000000000000000001
100000000000000000000000000000120000000000000000000000000000000001111111110000000000000000000000020000000000000021200000000000000000000000000000000001
100000000000000000000000000000120000000000000000000000000000000000000000000000000000000000000000020000000000000021200000000000000000000000000000000001
100000000000000000000000000000120000000000000000000000000000000110000000001100000000000000000000020000000000000021200011000000000000000000000000000001
100000000000000000000000000000120000000000000000000000000000000210000000001200000000000000001100020000000000000021200021000000000000000000000000000001
100000000000000000000000000000120000000000000000000000000000000210000000001200000000000000001200020000000000000021200021000000000000000000000000000001
100000000000000000000000000000120000000000000000000000000000000210000000001200000000000000001200020000000000000021200021000000000000000000000000000001
100000000000000000000000000000124000000000000000000000000000000210000000001200000000000000001200020000000000000021200021000000000000000000000000000001
100000000000000000000000000000120000000000000000000000000000000210000000001200000000000000001200020000000000000011100021000000000000000000000000000001
100000000000000000000000000000110000000000000000000000000000000210000000001200000000000000001100020000000000000000000021000000000000000000000000000001
100000000000000000000000000000000000000000000000000000000000000210000000001200000000000000000000020000000000000000000021000000000000000000000000000001
100000000000000000000000000000000003000000000000000000000000000110000000001100000000000000000000010000000000000000000011000000000000000000000000000001
100000000000000000000000000000000000000000111000000001110000000000000000000000000000011100000000000000000000000000000110000000000000000000000000000001
100000000000000000000000000000000122222222101222222221012222210000000000000001222222210122222222101222222222222222221100000000000000000000000000000001
100000000000000000000000000000000111111111101111111111011111110000000000000001111111110111111111101111111111111111111000000000000000000000000000000001
100000000000000000000000000000000000000000000000000000000000000000000000000000000000000000000000000000000000000000000000000000000000000000000000000001
100000000000000000000000000000000000000000000000000000000000000000000000000000000000000000000000000000000000000000000000000000000000000000000000000001
100000000000000000000000000000000000000000000000000000000000000000000000000000000000000000000000000000000000000000000000000000000000000000000000000001
100000000000000000000000000000000000000000000000000000000000000000000000000000000000000000000000000000000000000000000000000000000000000000000000000001
100000000000000000000000000000000000000000000000000000000000000000000000000000000000000000000000000000000000000000000000000000000000000000000000000001
100000000000000000000000000000000000000000000000000000000000000000000000000000000000000000000000000000000000000000000000000000000000000000000000000001
100000000000000000000000000000000000000000000000000000000000000000000000000000000000000000000000000000000000000000000000000000000000000000000000000001
100000000000000000000000000000000000000000000000000000000000000000000000000000000000000000000000000000000000000000000000000000000000000000000000000001
100000000000000000000000000000000000000000000000000000000000000000000000000000000000000000000000000000000000000000000000000000000000000000000000000001
100000000000000000000000000000000000000000000000000000000000000000000000000000000000000000000000000000000000000000000000000000000000000000000000000001
100000000000000000000000000000000000000000000000000000000000000000000000000000000000000000000000000000000000000000000000000000000000000000000000000001
100000000000000000000000000000000000000000000000000000000000000000000000000000000000000000000000000000000000000000000000000000000000000000000000000001
100000000000000000000000000000000000000000000000000000000000000000000000000000000000000000000000000000000000000000000000000000000000000000000000000001
100000000000000000000000000000000000000000000000000000000000000000000000000000000000000000000000000000000000000000000000000000000000000000000000000001
100000000000000000000000000000000000000000000000000000000000000000000000000000000000000000000000000000000000000000000000000000000000000000000000000001
100000000000000000000000000000000000000000000000000000000000000000000000000000000000000000000000000000000000000000000000000000000000000000000000000001
100000000000000000000000000000000000000000000000000000000000000000000000000000000000000000000000000000000000000000000000000000000000000000000000000001
100000000000000000000000000000000000000000000000000000000000000000000000000000000000000000000000000000000000000000000000000000000000000000000000000001
100000000000000000000000000000000000000000000000000000000000000000000000000000000000000000000000000000000000000000000000000000000000000000000000000001
100000000000000000000000000000000000000000000000000000000000000000000000000000000000000000000000000000000000000000000000000000000000000000000000000001
100000000000000000000000000000000000000000000000000000000000000000000000000000000000000000000000000000000000000000000000000000000000000000000000000001
100000000000000000000000000000000000000000000000000000000000000000000000000000000000000000000000000000000000000000000000000000000000000000000000000001
100000000000000000000000000000000000000000000000000000000000000000000000000000000000000000000000000000000000000000000000000000000000000000000000000001
100000000000000000000000000000000000000000000000000000000000000000000000000000000000000000000000000000000000000000000000000000000000000000000000000001
100000000000000000000000000000000000000000000000000000000000000000000000000000000000000000000000000000000000000000000000000000000000000000000000000001
100000000000000000000000000000000000000000000000000000000000000000000000000000000000000000000000000000000000000000000000000000000000000000000000000001
100000000000000000000000000000000000000000000000000000000000000000000000000000000000000000000000000000000000000000000000000000000000000000000000000001
100000000000000000000000000000000000000000000000000000000000000000000000000000000000000000000000000000000000000000000000000000000000000000000000000001
100000000000000000000000000000000000000000000000000000000000000000000000000000000000000000000000000000000000000000000000000000000000000000000000000001
111111111111111111111111111111111111111111111111111111111111111111111111111111111111111111111111111111111111111111111111111111111111111111111111111111