11111111111111111111111111111111111111111111111111
10000000000000000000000000000000000000000000000001
10000000000000000000000000000000000000000000000001
10000000000000000000000000000000000000000000000001
10000000000000000000000000000000000000000000000001
10000000000000000000000000000000000000000000000001
10011111111111111111111110000000000000000000000001
10012222222222222222222210000000000000000000000001
10000400000000000000000000000000000000000000000001
10000000000000000000000000000000000000000000000001
10000000000000000000000000000000000001110000000001
10000000000000000000122222222222222221010000000001
10000000000000000000000000000000000001110000000001
10000000000000000000000000000000000000000000000001
10000001110000000000000000000000000000000000000001
10000001012222222222222100000000000000000000000001
10000001110000000000000000000000000000000000000001
10000000000000000000000000000000000000000000000001
10000000000000000000000000000000000000011100000001
10000000000000000000122222222222222222210100000001
10000000000000000000000000000000000000011100000001
10000000000000000000000000000000000000000000000001
10000000111000000000000000000000000000000000000001
10000000101222222222221000000000000000000000000001
10000000111000000000000000000000000000011100000001
10000000000000000001222222222222222222210100000001
10000000000000000000000000000000000000011100000001
10000000000000000000000000000000000000000000000001
10000000001110000000000000000000000000000000000001
10000000001012222222222210000000000000000000000001
10000000001110000000000000000000000000000000000001
10000000000000000000000000000000000000000000000001
10000000000000000000000000000000000011100000000001
10000000000000000001222222222222222210100000000001
10000000000000000000000000000000000011100000000001
10000000000000000000000000000000000000000000000001
10000300000000000000000000000000000000000000000001
10012222222222222222221000000000000000000000000001
10011111111111111111111000000000000000000000000001
10000000000000000000000000000000000000000000000001
10000000000000000000000000000000000000000000000001
10000000000000000000000000000000000000000000000001
10000000000000000000000000000000000000000000000001
10000000000000000000000000000000000000000000000001
10000000000000000000000000000000000000000000000001
10000000000000000000000000000000000000000000000001
10000000000000000000000000000000000000000000000001
10000000000000000000000000000000000000000000000001
10000000000000000000000000000000000000000000000001
11111111111111111111111111111111111111111111111111
