111111111111111111111111111111111111111111111111111111111111111111111111111111111111111111
100000000000000000000000000000000000000000000000000000000000000000000000000000000000000001
100000000000000000000000000000000000000000000000000000000000000000000000000000000000000001
100000000000000000000000000000000000000000000000000000000000000000000000000000000000000001
100000000000000000000000000000000000000000000000000000000000000000000000000000000000000001
100000000000000000000000000000000000000000000000000000000000000000000000000000000000000001
100000000000000000000000000000000000000000000000000000000000000000000000000000000000000001
100000000000000000000000000000000000000000000000000000000000000000000000000000000000000001
100000000000000000000000000000000000000000000000000000000000000000000000000000000000000001
100000000000000000000000000000000000000000000000000000000000000000000000000000000000000001
100000000000000000000000000000000000000000000000000000000000000000000000000000000000000001
100000000000000000000000000000000000000000000000000000000000000000000000000000000000000001
100000000000000000000000000000000000000000000000000000000000000000000000000000000000000001
100000000000000000000000000000000000000000000000000000000000000000000000000000000000000001
100000000000000000000000000000000000000000000000000000000000000000000000000000000000000001
100000000000000000000000000000000000000000000000000000000000000000000000000000000000000001
100000000000000000000000000000000000000000000000000011100000000000000000000000000000000001
100000000000000000000000000000000000000000000000000010100000000000000000000000000000000001
100000000000000000000000000000000000000000000000000011100000000000000000000000000000000001
100000000000000000000000000000000000000000000000000002000000000000000000000000000000000001
100000000000000000000000000000000000000000000000000002000000000000000000000000000000000001
100000000000000000000000000000000000000000000000000002000000000000000000000000000000000001
100000000000000000000000000000000000000000000000000002000000000000000000000000000000000001
100000000000000000000000000000000000000000000000000002000000000000000000000000000000000001
100000000000000000000000000000000000000000000000000002000000000000000000000000000000000001
100000000000000000000000000000000000000000000000000002000000000000000000000000000000000001
100000000000000000000000000000000000000000000000000002000000000000000000000000000000000001
100000000000000000000000000000000000000000000000000002000000000000000000000000000000000001
100000000000000000000000000000000000000000000000000002000000000000000000000000000000000001
100000000000000000000000000000000000000000000000000002000000000000000000000000000000000001
100000000000000000000000000000000000000000000000000002000000000000000000000000000000000001
100000000000000000000000000000000000000000000000000002000000000000000000000000000000000001
100000000000000000000000000000000000000000000000000002000000000000000000000000000000000001
100000000000000000000000000000000000000000000000000002000000000000000000000000000000000001
100000000000000000000000000000000000000000000000000002000000000000000000000000000000000001
100000000000000000000000000000000000000000000000000002000000000000000000000000000000000001
100000000000000000000000000000000000000000000000000002000000000000000000000000000000000001
100000000000000000000000000000000000000000000000000002000000000000000000000000000000000001
100000000000000111111111111111110000000000000000000002000000000000000000000000000000000001
100000000000000122222222222222211111111111111110000002000011100000000000000000000000000001
100000000000000000000000000000012222222222222211000002000010100000000000000000000000000001
110003000000000000000000000000000000000000000001100002000011100111111111111000000000000001
112222222222222222100000000000000000000000000000100002000000000122222222221000000000000001
111111111111111111100000000000000000000011100000200002000000000000000000000000000000000001
100000000000000000000000000000000000000010100000200001000000000000000000000000000000000001
100000000000000000000000000000000000000011100000200001100000000000011100000000001110000001
100000000000000000000000000000000000000000000000200001112222222210010100122222221010000001
100000000000000000000000000000000000000000000000200000000000000000011100000000001110000001
100000000000000000000000000000000000000000000000200011100000000000002000000000000000000001
100000000000000000000000000000000000000000000000200010100000000000002000000000000000000001
100000000000000000000000000000000000000000000000200011100000000000002000000000000000000001
100000000000000000000000000000000000000000000000200000000000000000002000000000000000000001
100000000000000000000000000000000000000000000000200000000000000000002000000000000000000001
100000000000000000000000000000000000000000000000200000000000000000002000000000000000000001
100000000000000000000000000000000000000000000000200000000000000000002000000000000000000001
100000000000000000000000000000000000000000000000200000000000000000002000000000000000000001
100000000000000000000000000000000000000000000000200000000000000000002000000000000000000001
100000000000000000000000000000000000000000000000200000000000000000002000000000000000000001
100000000000000000000000000000000000000000000011100000000000000000002000000000000000000001
100000000000000000000000000000000000000000000020000000000000000000002000000000000000000001
100000000000000000000000000000000000000000000020000000000000000000001110000000000000000001
100000000000000000000000000000000000000000000020000000000000000000000120000000000000000001
100000000000000000000000000000000000000000000020000000000000000000000120000000000000000001
100000000000000000000000000000000000000000000020000000000000000000000120000000000000000001
100000000000000000000000000000000000000000000020000000000000000000000120000000000000000001
100000000000000000000000000000000000000000000020000000000000000000000120000000000000000001
100000000000000000000000000000000000000000000020000000000000000000000120000000000000000001
100000000000000000000000000000000000000000000020000000000000000000000120000000000000000001
100000000000000000000000000000000000000000000020000000000000000000000120000000000000000001
100000000000000000000000000000000000000000000020000000000000000000000120000000000000000001
100000000000000000000000000000000000000000000020000000000000000000000120000000000000000001
100000000000000000000000000000000000000000000020000000000000000000000110000000000000000001
100000000000000000000000000000000000000000000020000000000000000000000011000000000000040001
100000000000000000000000000000000000000000000020000000000000000000000001122222222222222211
100000000000000000000000000000000000000000000020000000000000000000000000111111111111111111
100000000000000000000000000000000000000000000020000000000000000000000000000000000000000001
100000000000000000000000000000000000000000000111000000000000000000000000000000000000000001
100000000000000000000000000000000000000000000101000000000000000000000000000000000000000001
100000000000000000000000000000000000000000000111000000000000000000000000000000000000000001
100000000000000000000000000000000000000000000000000000000000000000000000000000000000000001
100000000000000000000000000000000000000000000000000000000000000000000000000000000000000001
100000000000000000000000000000000000000000000000000000000000000000000000000000000000000001
100000000000000000000000000000000000000000000000000000000000000000000000000000000000000001
100000000000000000000000000000000000000000000000000000000000000000000000000000000000000001
100000000000000000000000000000000000000000000000000000000000000000000000000000000000000001
100000000000000000000000000000000000000000000000000000000000000000000000000000000000000001
100000000000000000000000000000000000000000000000000000000000000000000000000000000000000001
100000000000000000000000000000000000000000000000000000000000000000000000000000000000000001
100000000000000000000000000000000000000000000000000000000000000000000000000000000000000001
111111111111111111111111111111111111111111111111111111111111111111111111111111111111111111
