111111111111111111111111111111111111111111111111111111111111111111111111111111111111111111
112222222210122222222222222222222221012222222222221212222222222211110000000000000000000001
100400000011100000000000000000000001110000000000001110000000000001110000000000000000000001
100000000000000000000000000000000000200000000000000000000000000000110000000000000000000001
100000000000000011100000000000000000200000000000000000000011100000210000000000000000000001
100000122222222210122222100000000000200000000000000000000010100000210000000000000000000001
100000111111111110111111100000000000200000000000000000000011100000210000000000000000000001
100000000000000000000000000000000000200000000000000000000000000000210000000000000000000001
100000000000000000000000000000000000200000000000000000000000000000210000000000000000000001
100000000000000000000000000000000000200000000000000000000000000000210000000000000000000001
100000000000000000000000000000000000200000000000000000000000000000210000000000000000000001
100000000000000000000000000000000000200000000000000000000000000000210000000000000000000001
100000000000000000000000000000000000200000000000000000000000000000210000000000000000000001
100000000000000000000000000000000000200000000000000000000000000000210000000000000000000001
100000000000000000000000000000000000200000000000000000000000000000210000000000000000000001
100000000000000000000000000000000000200000000000000000000000000001110000000000000000000001
100000000000000000000000000000000000200000000000000000000000000001000000000000000000000001
100000000000000000000000000000000001110000000000000000000000000001110000000000000000000001
100000000000000000000000000000000001010000000000000000000000000000210000000000000000000001
100000000000000000000000000000000001110000000000000000000000000000210000000000000000000001
100000000000000000000000000000000000000000000000000000000000000000210000000000000000000001
100000000000000000000000000000000000000000000000000000000000000000210000000000000000000001
100000000000000000000000000000000000000000000000000000000000000000210000000000000000000001
100000000000000000000000000000000000000000000000000000000000000001110000000000000000000001
100000000000000000000000000000000000000000000000000000000000000001000000000000000000000001
100000000000000000000000000000000000000000000000000000000000000001110000000000000000000001
100000000000000000000000000000000000000000000000000000000000000000210000000000000000000001
100000000000000000000000000000000000000000000000000000000000000000210000000000000000000001
100000000000000000000000000000000000000000000000000000000000000000210000000000000000000001
100000000000000000000000000000000000000000000000000000000000000000210000000000000000000001
100000000000000000000000000000000000000000000000000000000000111000210000000000000000000001
100000000000000000000000000000000000000000000000000000000000101000210000000000000000000001
100000000000000000000000000000000000000000000000000000000000111000210000000000000000000001
100000000000000000000000000000000000000000000000000000000000000000210000000000000000000001
100000000000000000000000000000000000000000000000000000000000000000210000000000000000000001
100000000000000000000000000000000000000000000000000000000000000000210000000000000000000001
100000000000000000000000000000000000000000000000000000000000000000210000000000000000000001
100000000000000000000000000000000000000000000000000000000000110000210000000000000000000001
100000000000000000000000000000000000000000000000000000000000120000210000000000000000000001
100000000000000000000000000000000000000000000000000000000000120000210000000000000000000001
100000000000000000000000000000000000000000000000000000000000120000110000000000000000000001
100000000000000000000000000000000000000000000000000000000000120000000000000000000000000001
100000000000000000000000000000000000000000000000000000000000120000000000000000000000000001
100000000000000000000000000000000000000000000000000000000000120000000000000000000000000001
100000000000000000000000000000000000000000000000000000000000120000000000000000000000000001
100000000000000000000000000000000000000000000000000000000000120000000000000000000000000001
100000000000000000000000000000000000000000000000000000000000120000000000000000000000000001
100000000000000000000000000000000000000000000000000000000000120000000000000000000000000001
100000000000000000000000000000000000000000000000000000000000120000000000000000000000000001
100000000000000000000000000000000000000000000000000000000000111000000000000000000000000001
100000000000000000000000000000000000000000000000000000000000101000000000000000111000000001
100000000000000000000000000000000000000000000000000111111111112222222222222222101000000001
100000000000000000000000000000001111111111111111111122222222210000000000000000111000000001
100000000000000000000000000000001222222222222222222100000000000000000000000000000000000001
100000000000000000000000000000000000000000000000000000000000000000000000000000000000000001
100000000000000000000000000000000000000000000000000000000000000000000000000000000000000001
100000000000000000000000000000000000000000000000000000000000000000000000000000000000000001
100000000000000000000000000000000000000010000000000000000000000000000000000000000000000001
100000001110000000000122222222222222221010000000000000000000000000000000000000000000000001
100000001012222222222100000000000000000010000000000000000000000000000000000000000000000001
100000001110000000000000000000000000000000000000000000000000000000000000000000000000000001
100000000000000000000000000000000000000000000000000000000000000000000000000000000000000001
100000000000000000000000000000000000000000000000000000000000000000000000000000000000000001
100000000000000000000000000000000000000000000000000000000000000000000000000000000000000001
100000000000000000000000000000001000000000000000000000000011100000000000000000000000000001
100000000000000000000000000000001012222222222222222222222210100000000000000000000000000001
100000000000000000000000000000001000000000000000000000000011100000000000000000000000000001
100000000000000000000000000000000000000000000000000000000000000000000000000000000000000001
100000000000000000000000000000000000000000000000000000000000000000000000000000000000000001
100000000000000000000000000000000000000000000000000000000000000000000000000000000000000001
100000000000000000000000000000000000000000000000000000000000000000000000000000000000000001
100000000000000000000001222222222222221000000000000000000000000000000000000000000000000001
111003000000000000000001111111111111111000000000000000000000000000000000000000000000000001
111222222222222222222221000000000000000000000000000000000000000000000000000000000000000001
111111111111111111111111000000000000000000000000000000000000000000000000000000000000000001
100000000000000000000000000000000000000000000000000000000000000000000000000000000000000001
100000000000000000000000000000000000000000000000000000000000000000000000000000000000000001
100000000000000000000000000000000000000000000000000000000000000000000000000000000000000001
100000000000000000000000000000000000000000000000000000000000000000000000000000000000000001
100000000000000000000000000000000000000000000000000000000000000000000000000000000000000001
100000000000000000000000000000000000000000000000000000000000000000000000000000000000000001
100000000000000000000000000000000000000000000000000000000000000000000000000000000000000001
100000000000000000000000000000000000000000000000000000000000000000000000000000000000000001
100000000000000000000000000000000000000000000000000000000000000000000000000000000000000001
100000000000000000000000000000000000000000000000000000000000000000000000000000000000000001
100000000000000000000000000000000000000000000000000000000000000000000000000000000000000001
100000000000000000000000000000000000000000000000000000000000000000000000000000000000000001
100000000000000000000000000000000000000000000000000000000000000000000000000000000000000001
100000000000000000000000000000000000000000000000000000000000000000000000000000000000000001
111111111111111111111111111111111111111111111111111111111111111111111111111111111111111111
