11111111111111111111111111111111111111111111111111
10000000000000000000000000000000000000000000000001
10000000000000000000000000000000000000000000000001
10000000000000000000000000000000000000000000000001
10000000000000000000000000000000000000000000000001
10000000000000000000000000000000000000000000000001
10000000000000000000000000000000000000000000000001
10000000000000000000000000001110000000000000000001
10000000000000000000000000001010000000000000000001
10000000000000000000000000001110000000000000000001
10000000000000000000000000000200000000000000000001
10000000000000000000000000000200000000000000000001
10000000000000000000000000000200000000000000000001
10000000000000000000000000000200000000000000000001
10000000000000000000000000000200000000000000000001
10000000000000000000000000000200000000000000000001
10000000000000000000000000000200000000000000000001
10000000000000000000000000000200000000000000000001
10000000000000000000000000000200000000000000000001
10000000000000000000000000000200000000000000000001
10000000000000000000000000000200000000000000000001
10000000000000000000000000001110000000001110000001
10000000000000000000012222221012222222221010000001
11100300000000000000011111111011111111111110000001
11122222222222222221000000000000000000001200000001
11111111111111111111000000000000000000001200000001
10000000000000000000000000000000000000001200000001
10000000000000000000000000000000000000001200000001
10000000000000000000000000000000000000001200000001
10000000000000000000000000000000000000001200000001
10000000000000000000000000000000000000001200000001
10000000000000000000000000000000000000001200000001
10000000000000000000000000000000000000001200000001
10000000000000000000000000000000000000001200000001
10000000000000000000000000000000000000001200000001
10000000000000000000000000000000000000001200000001
11111111111011111111111111011111111111111110000001
11122222221012222222222221012222222222221010000001
11100400001110000000000001110000000000001110000001
11100000000000000000000000000000000000000000000001
10000000000000000000000000000000000000000000000001
10000000000000000011100000000000000000000000000001
10000012222222222210122222222222100000000000000001
10000011111111111110111111111111100000000000000001
10000000000000000000000000000000000000000000000001
10000000000000000000000000000000000000000000000001
10000000000000000000000000000000000000000000000001
10000000000000000000000000000000000000000000000001
10000000000000000000000000000000000000000000000001
11111111111111111111111111111111111111111111111111
