11111111111111111111111111111111111111111111111111111111111111111111111111111111
10000000000000000000000000000000000000000000000000000000000000000000000000000001
10000000000000000000000000000000000000000000000000000000000000000000000000000001
10000000000000000000000000000000000000000000000000000000000000000000000000000001
10000000000000000000000000000000000000000000000000000000000000000000000000000001
10000000000000000000000000000000000000000000000000000000000000000000000000000001
10000000000000000000000000000000000000000000000000000000000000000000000000000001
10000000000000000000000000000000000000000000000000000000000000000000000000000001
10000000000000000000000000000000000000000000000000000000000000000000000000000001
10000000000000000000000000000000000000000000000000000000000000000000000000000001
10000000000000000000000000000000000000000000000000000000000000000000000000000001
10000000000000000000000000000000000000000000000000000000000000000000000000000001
10000000000000000000000000000000000000000000000000000000000000000000000000000001
10000000000000000000000000000000000000000000000000000000000000000000000000000001
10000000000000000000000000000000000000000000000000000000000000000000000000000001
10000000000000000000000000000000000000000000000000000000000000000000000000000001
10000000000000000000000000111111111111110111111111110000000000000000000000000001
10000000000000000000000000101222222222210122222222210000000000000000000000000001
10000000000000000000000000111000000000011100000000000000000000000000000000000001
10000000000000000000000000000000000000000000000000000000000000000000000000000001
10000000000000000000000000000000000000000000000000000000000000000000000000000001
10000000000000000000000000000000000000000000000000000000000000000000000000000001
10000000000000000000000000000000000000000000000000000000000000000000000000000001
10000000111000000000000000000000111000000000001110000000000000000111000000000001
10000000101222222222222222222222101222222222221012222222222222222101000000000001
10000000111000000000000000000000111111111111111011111111111111111111000000000001
10000000000000000000000000000000000000000000000000000000000000000120000000000001
10000000000000000000000000000000000000000000000000000000000000000120000000000001
10000000000000000000000000000000000000000000000000000000000000000120000000000001
10000000000000000000000000000000000000000000000000000000000000000120000000000001
10000000000000000000000000000000000000000000000111000000000000000120000000000001
10000000000000000000000000000000000000000000400111000000000000000120000000000001
10000000000000000000000001222222222222222222222111000000000000000120000000000001
10000000000000000000000001111111111111111111111111000000000000000120000000000001
10000000000000000000000000000000000000000000000000000000000000000120000000000001
10000000000000000000000000000000000000000000000000000000000000000120000000000001
10000000000000000000000000000000000000000000000000000000000000000120000000000001
10000000000000000000000000000000000000000000000000000000000000000120000000000001
10000000000000000000000000000000000000000000000000000000000000000111000000000001
10000000000000000000000000000000000000000000000000000000000000000001000000000001
10000000000000000000000000000000000000000000000000000000000000000111000000000001
10000000000000000000000000000000000000000000000000000000000000000120000000000001
10000000000000000000000000000000000000000000000000000000000000000120000000000001
10000000000000000000000000000000000000000000000000000000000000000120000000000001
10000000000000000000000000000000000000000000000000000000000000000120000000000001
10000000000000000000000000000000000000000000000000000000000000000120000000000001
10000000000000000000000000000000000000000000000000000000000000000120000000000001
10000000000000000000000000000000000000000000000000000000000000000120000000000001
10000000000000000000000000000000000000000000000000000000000000000120000000000001
10000000000000000000000000000000000000000000000000000000000000000120000000000001
10000000000000000000000000000000000000000000000000000000000000000120000000000001
10000000000000000000000000000000000000000000000000000000000000000120000000000001
10000000000000000000000000000000011111111111111111011111111111111110000000000001
10000000000000000000000000000000012222222222222221012222222222221010000000000001
10000000000000000000000000000000000000000000000001110000000000001110000000000001
10000000000000000000000000000000000000000000000000000000000000000000000000000001
10000000000000000000000000000000000000000000000000000000000000000000000000000001
10000000000000000000000000000000000000000000000000000000000000000000000000000001
10000000000000000000000000000000000000000000000000000000000000000000000000000001
10000000000000000000000000012222222100000000000000000000000000000000000000000001
10000000000000000000000000011111111100000000000000000000000000000000000000000001
10000000000000012222222221000000000000000000000000000000000000000000000000000001
10000000000000011111111111000000000000000000000000000000000000000000000000000001
10003000000000000000000000000000000000000000000000000000000000000000000000000001
11222222222210000000000000000000000000000000000000000000000000000000000000000001
11111111111110000000000000000000000000000000000000000000000000000000000000000001
10000000000000000000000000000000000000000000000000000000000000000000000000000001
10000000000000000000000000000000000000000000000000000000000000000000000000000001
10000000000000000000000000000000000000000000000000000000000000000000000000000001
10000000000000000000000000000000000000000000000000000000000000000000000000000001
10000000000000000000000000000000000000000000000000000000000000000000000000000001
10000000000000000000000000000000000000000000000000000000000000000000000000000001
10000000000000000000000000000000000000000000000000000000000000000000000000000001
10000000000000000000000000000000000000000000000000000000000000000000000000000001
10000000000000000000000000000000000000000000000000000000000000000000000000000001
10000000000000000000000000000000000000000000000000000000000000000000000000000001
10000000000000000000000000000000000000000000000000000000000000000000000000000001
10000000000000000000000000000000000000000000000000000000000000000000000000000001
10000000000000000000000000000000000000000000000000000000000000000000000000000001
11111111111111111111111111111111111111111111111111111111111111111111111111111111
