1111111111111111111111111111111111111111111111111111111111111111111111111111111111111111111111111111
1000000000000000000000000000000000000000000000000000000000000000000000000000000000000000000000000001
1000000000000000000000000000000000000000000000000000000000000000000000000000000000000000000000000001
1000000000000000000000000000000000000000000000000000000000000000000000000000000000000000000000000001
1000000000000000000000000000000000000000000000000000000000000000000000000000000000000000000000000001
1000000000000000000000000000000000000000000000000000000000000000000000000000000000000000000000000001
1000000000000000000000000000000000000000000000000000000000000000000000000000000000000000000000000001
1000000000000000000000000000000000000000000000000000000000000000000000000000000000000000000000000001
1000000000000000000000000000000000000000000000000000000000000000000000000000000000000000000000000001
1000000000000000000000000000000000000000000000000000000000000000000000000000000000000000000000000001
1000000000000000000000000000000000000000000000000000000000000000000000000000000000000000000000000001
1000000000000000000000000000000000000000000000000000000000000000000000000000000000000000000000000001
1000000000000000000000000000000000000000000000000000000000000000000000000000000000000000000000000001
1000000000000000000000000000000000000000000000000000000000000000000000000000000000000000000000000001
1000000000000000000000000000000000000000000000000000000000000000000000000000000000000000000000000001
1000000000000000000000000000000000000000000000000000000000000000000000000000000000000000000000000001
1000000000000000000000000000000000000000000000000000000000000000000000000000000000000000000000000001
1000000000000000000000000000000000000000000000000000000000000000000000000000000000000000000000000001
1000000000000000000000000000000000000000000000000000000000000000000000000000000000000000000000000001
1000000000000000000000000000000000000000000000000000000000000000000000000000000000000000000000000001
1000000000000000000000000000000000000000000000000000000000000000000000000000000000000000000000000001
1000000000000000000000000000000000000000000000000000000000000000000000000000000000000000000000000001
1000000000000000000000000000000000000000000000000000000000000000000000000000000000000000000000000001
1000000000000000000000000000000000000000000000000000000000000001110000000000000000000000000000000001
1000000000000000000000000000000000000000000000000000000000000001010000000000000000000000000000000001
1000000000000000000000000000000000000000000000000000000000000001110000000000000000000000000000000001
1000000000000000000000000000000000000000000000000000000000000000200000000000000000000000000000000001
1000000000000000000000000000000000000000000000000000000000000000200000000000000000000000000000000001
1000000000000000000000000000000000000000000000000000000000000000200000000000000000000000000000000001
1000000000000000000000000000000000000000000000000000000000000000200000000000000000000000000000000001
1000000000000000000000000000000000000000000000000000000000011000200000000000000000000000000000000001
1000000000000000000000000000000000000000000000000000000000012000100000000000000000000000000000000001
1000000000000000000000000000000000000000000000000000000000012000000000000000000000000000000000000001
1000000000000000000000000000000000000000000000000000000000012000100000000000000000000000000000000001
1000000000000000000000000000000000000000001000000000000000011000200000000000000000000000000000000001
1000000000000000000000000000000000000000002000000000000000000000200000000000000000000000000000000001
1000000000000000000000000000000000000000002000000000000000000000200000000000000000000000000000000001
1000000000000000000000000000000000000000002000000000000000000000200000000000000000000000000000000001
1000000000000000000000000000000000000000002000000000000000000000200000000000000000000000000000000001
1000000000000000000000000000000000000000002000000000000000000000200000000000000000000000000000000001
1000000000000000000000000000000000000000011100000000000000000001110000000000000000000000000000000001
1000000000000000000000000000000000012222210100000000000000000001010000000000000000000000000000000001
1000000000000000000000000000000000000000011100000000000000000001110000000000000000000000000000000001
1000000000000000000000000000000000000000002000000000000000000000200000000000000000000000000000000001
1000000000000000000000000000000000000000002000000000000000000000200000000000000000000000000000000001
1000000000000000000000000000000000000000042000000000000000000000200000000000000000000000000000000001
1000000000000000000000000000000000000000002000000000000000000000200000000000000000000000000000000001
1000000000000000000000000000000000000000001000000000000000000000200000000000000000000000000000000001
1000000000000000000000000000000000000000000000000000001110000001110000000000000000000000000000000001
1000000000000000000000000000000000000000000012222222221012222221010000000000000000000000000000000001
1000000000000000000000000000000000000000000011111111111011111111010000000000000000000000000000000001
1000000000000000000000000000000000000000000012222222221012222221010000000000000000000000000000000001
1000000000000000000000000000000000000000000000000000001110000001110000000000000000000000000000000001
1000000000000000000000000000000000000000000000000000000000000000200000000000000000000000000000000001
1000000000000000000000000000000000000000000000000000000000000000200000000000000000000000000000000001
1000000000000000000000000300000000012222222221000000000000000000200000000000000000000000000000000001
1000000000000000000000000000000000011111111111000000000000000000200000000000000000000000000000000001
1000000000000000000000012222222221000000000000000000000000000000200000000000000000000000000000000001
1000000000000000000000011111111111000000000000000000000000000001110000000000000000000000000000000001
1000000000000000000000000000000000000000000000000000000000000001010000000000000000000000000000000001
1000000000000000000000000000000000000000000000000000000000000001110000000000000000000000000000000001
1000000000000000000000000000000000000000000000000000000000000000200000000000000000000000000000000001
1000000000000000000000000000000000000000000000000000000000000000200000000000000000000000000000000001
1000000000000000000000000000000000000000000000000000000000000000200000000000000000000000000000000001
1000000000000000000000000000000000000000000000000000000000000000200000000000000000000000000000000001
1000000000000000000000000000000000000000000000000000000000000000200000000000000000000000000000000001
1000000000000000000000000000000000000000000000000000000000011000200000000000000000000000000000000001
1000000000000000000000000000000000000000000000000000000000012000100000000000000000000000000000000001
1000000000000000000000000000000000000000000000000000000000012000000000000000000000000000000000000001
1000000000000000000000000000000000000000000000000000000000012000100000000000000000000000000000000001
1000000000000000000000000000000000000000000000000000000000011000200000000000000000000000000000000001
1000000000000000000000000000000000000000000000000000000000000000200000000000000000000000000000000001
1000000000000000000000000000000000000000000000000000000000000000200000000000000000000000000000000001
1000000000000000000000000000000000000000000000000000000000000000200000000000000000000000000000000001
1000000000000000000000000000000000000000000000000000000000000000200000000000000000000000000000000001
1000000000000000000000000000000000000000000000000000000000000001110000000000000000000000000000000001
1000000000000000000000000000000000000000000000000000000000000001010000000000000000000000000000000001
1000000000000000000000000000000000000000000000000000000000000001110000000000000000000000000000000001
1000000000000000000000000000000000000000000000000000000000000000000000000000000000000000000000000001
1000000000000000000000000000000000000000000000000000000000000000000000000000000000000000000000000001
1000000000000000000000000000000000000000000000000000000000000000000000000000000000000000000000000001
1000000000000000000000000000000000000000000000000000000000000000000000000000000000000000000000000001
1000000000000000000000000000000000000000000000000000000000000000000000000000000000000000000000000001
1000000000000000000000000000000000000000000000000000000000000000000000000000000000000000000000000001
1000000000000000000000000000000000000000000000000000000000000000000000000000000000000000000000000001
1000000000000000000000000000000000000000000000000000000000000000000000000000000000000000000000000001
1000000000000000000000000000000000000000000000000000000000000000000000000000000000000000000000000001
1000000000000000000000000000000000000000000000000000000000000000000000000000000000000000000000000001
1000000000000000000000000000000000000000000000000000000000000000000000000000000000000000000000000001
1000000000000000000000000000000000000000000000000000000000000000000000000000000000000000000000000001
1000000000000000000000000000000000000000000000000000000000000000000000000000000000000000000000000001
1000000000000000000000000000000000000000000000000000000000000000000000000000000000000000000000000001
1000000000000000000000000000000000000000000000000000000000000000000000000000000000000000000000000001
1000000000000000000000000000000000000000000000000000000000000000000000000000000000000000000000000001
1000000000000000000000000000000000000000000000000000000000000000000000000000000000000000000000000001
1000000000000000000000000000000000000000000000000000000000000000000000000000000000000000000000000001
1000000000000000000000000000000000000000000000000000000000000000000000000000000000000000000000000001
1000000000000000000000000000000000000000000000000000000000000000000000000000000000000000000000000001
1000000000000000000000000000000000000000000000000000000000000000000000000000000000000000000000000001
1111111111111111111111111111111111111111111111111111111111111111111111111111111111111111111111111111
